11111111111111111111111111111
1E0000000000000C00000C0000001
10100101001000001010010001101
10100100101010100010010001101
1P0000000C00C00000000000000C1
11111111111111111111111111111