11111111111111111111111111111
1C100000000000000000000000001
1E100101001000001010010001101
10100100101010100010010001101
1P000000000000000000000000001
11111111111111111111111111111