111111111111111
11110C0000001C1
1110011111C0001
1P0011000000111
1001100EC111111
10010C0000000C1
111111111111111