1111111111111
10110000001C1
1000011111011
1P00111E00001
1111111111111