1111111111111
10110000000C1
1C00011111011
1PC0111E00001
1111111111111