1111111111111
1111000000001
10C0011111011
1P10111EC0001
1111111111111