111111111111111
11110C000000XC1
1110011111C0001
1P0011000000111
1X011XXEC111111
1X010C000000CX1
111111111111111