111111111111111
11110C0000001C1
1110011111C0001
1P001X000000111
1X01100EC111111
100X0C0000000C1
111111111111111