111111111111111
11110C0000001C1
1110011111C0001
1P001X000000111
1X011000C111111
100X0C000000EC1
111111111111111