111111111111111
11110C0000001C1
1110011111C0001
1P0011X00000111
1001100EC111111
1X010C0000000C1
111111111111111