111111111111
111111111111
111111EPC111
111111111111