1111111111111
10010000000C1
1000011111001
1P001110000X1
1111111111111