1111111111111
1001000000XC1
1000011110011
1P0011E000001
1111111111111