1111111111111
10010000000C1
10000111110
1P0011E000X01
111111111