1111111111111
1001000P000C1
100001111E001
1P001110000X1
1111111111111