1111111111111
1011000000011
1000011110011
1P0011E000001
1111111111111