1111111111111
1001000P000C1
100001111E001
1P00111000001
1111111111111