1111111111111
1001000P000C1
100001111E001
100L11100S001
1111111111111